A an - неопределенный артикль
aged - в возрасте
abandon - отказаться от
agency - агентство
ability - способность
agenda - повестка дня
able - способный
agent - агент
about - о
aggressive - агрессивный
above - выше
ago - назад
abroad - за границу
agree - согласен
absolute - абсолютный
agreement - договор
absolutely - абсолютно
ah - восклицание «А!»
academic - академический
ahead - впереди
accept - принять
aid - помощь
acceptable - приемлемый
aim - цель
access - доступ
air - воздух
accident - авария
aircraft - самолет
accommodation - размещение
airline - авиакомпания
accompany - сопровождать
airport - аэропорт
according - согласно
alarm - сигнализация
account - счет
album - альбом
accurate - точный
alcohol - спирт
accuse - обвинять против
alcoholic - алкогольный
achieve - достичь
alive - живой
achievement - достижение
all - все
acknowledge - признать
all right - ладно
acquire - приобрести
allow - разрешить
across - поперек через
almost - почти
act - действовать
alone - только
action - действие
along - по вдоль
active - активный
already - уже
activity - деятельность
also - также
actor - актер
alter - изменить
actress - актриса
alternative - альтернатива
actual - фактический
although - хотя
actually - на самом деле
always - всегда
amazed - удивленный
adapt - адаптировать
amazing - удивительный
add - добавить
ambition - амбиции
addition - дополнение
ambitious - амбициозный
additional - дополнительный
among - среди
address - адрес
amount - сумма
administration - администрация
analyse - анализировать
admire - восхищаться
analysis - анализ
admit - признать
ancient - древний
adopt - принять
and - и
adult - взрослый
ange - гнев
advance - продвигать
In advance - заранее
angle - угол
advanced - продвинутый
angry - злой
advantage - преимущество
animal - животное
adventure - приключение
ankle - лодыжка
advertise - рекламировать
anniversary - юбилей
advertisement - реклама
announce - объявить
advertising - рекламирование
announcement - объявление
advice - совет
annoy - раздражать
advise - советовать
annoyed - раздраженный
affair - дело
annoying - раздражающий
affect - влияет
annual - ежегодный
afford - позволить
another - другой
afraid - испуганный
answer - ответ
after - после
anxious - тревожный
afternoon - полдень
any - любой
afterwards - потом
anybody - кто-нибудь
again - снова
any - больше
against - против
anyone - любой
age - возраст
anything - что-нибудь
anyway - в любом случае
attend - присутствовать
anywhere - везде
attention - внимание
apart - кроме
attitude - отношение
apartment - квартира
attract - привлечь
apologize - извиниться
attraction - аттракцион
app - приложение
attractive - привлекательный
apparent - кажущийся
audience - аудитория
apparently - видимо
August - Август
appeal - обращаться
aunt - тетя
appear - появляться
author - автор
appearance - внешний вид
authority - власть
apple - яблоко
autumn - осень
application - приложение
available - доступно
apply - применить
average - средний
appointment - назначение
avoid - избегать
appreciate - ценить
award - награда
approach - подход
aware - осведомленный
appropriate - соответствующий
away - прочь
approval - утверждение
awful - ужасный
approve - одобрить
baby - ребенок
approximately - примерно
back - спина
back - назад
April - Апрель
background - фон
architect - архитектор
backwards - назад
architecture - архитектура
bacteria - бактерии
area - площадь
bad - плохой
argue - спорить
badly - плохо
argument - аргумент
bag - сумка
arise - возникновение
bake - испечь
arm - рука
balance - остаток
armed - вооруженный
ball - мяч
arms - оружие
ban - запретить
army - армия
banana - банан
around - вокруг
band - группа
arrange - организовать
bank (money) - банк (деньги)
arrangement - договоренность
bank (river) - берег (река)
arrest - арестовать
bar - бар
arrival - прибытие
barrier - барьер
arrive - прибыть
base - база
art - искусство
baseball - бейсбол
article - статья
based - на основе
artificial - искусственный
basic - базовый
artist - художник
basically - в основном
artistic - художественный
basis - база
as - как
